# Map file for tile-based game
# (Lines that start with '#' are comments)
# The tiles are:
#   (Space) Empty tile
#   A		Ground Tile (G)
#	B		Wall-Tile Non-attachable (WN)
#	C		Velcro Tile (V)
#	D		Box (B)
#	E		Spikes (S)
#	F		Velcro Toggle
#	G		Sand 
#   o       Star
#   !       Music Note
#   *       Goal
#   1       Shoe Snake
#   2       Shoe Snail
#   3       ShoeGull
#   4       BrickFlop
+background.png
							
CCCCCCCCCCCCCCCBBBBBBBBBBBBBBCCCCCCCCCCCCCBBBBBBBBBBBBBBBBBBBBBBBBBBBBBBBBBBBB
C                           BC                                               B 
C                           BC                                               B  
C                           BC                                               B  
C                           BC          B                                    B 
C                           BC          B                                    B
C                           BC          B                                    B
C                           BC          B                                    B
C              D      2          2      B                                    B
C              AAAAAAAAAAAAAAAAAAAAAAAAAAAAAAAAAAAA                          B
C                                                                            B
C                                                                            B
C     CC              CC            CC                                       B
C     CC              CC     BB     CC                   *                   B
C                            BB                         BBBBBBBBBBBBBBBBBBBBBB
C            BB              BB                         BBBBBBBBBBBBBBBBBBBBBB  
C                            BB                         BBBBBBBBBBBBBBBBBBBBBB
C                            BB           DD            BBBBBBBBBBBBBBBBBBBBBB
CEEEEEEEEEEEEEEEEEEEEEEEEEEEEBB           DD            BBBBBBBBBBBBBBBBBBBBBB
AAAAAAAAAAAAAAAAAAAAAAAAAAAAAAAAAAAAAAAAAAAAAAAAAFF   AAAAAAAAAAAAAAAAAAAAAAAA
BBBBBBBBBBBBBBBBBBBBBBBBBBBBBBBBBBBBBBBBBBBBBBBBBFF   BBBBBBBBBBBBBBBBBBBBBBBB                                                                
B                                                                BBBBBBBBBBBBB
B                                    3                           BBBBBBBBBBBBB
B                                                                BBBBBBBBBBBBB
B                                                                BBBBBBBBBBBBB
B                                                                BBBBBBBBBBBBB
B                       DD                                       BBBBBBBBBBBBB
B   p           DD      DD                                       BBBBBBBBBBBBB
B       DD      DDEEEEEEDD    2                  BB             oBBBBBBBBBBBBB
AAAAAAAAAAAAAAAAAAAAAAAAAAAAAAAAAAAAAAAAAAAAAAAAAAAAAAAAAAAAAAAAAAAAAAAAAAAAAA