# Map file for tile-based game
# (Lines that start with '#' are comments)
# The tiles are:
#   (Space) Empty tile
#   A		Ground Tile (G)
#	B		Wall-Tile Non-attachable (WN)
#	C		Velcro Tile (V)
#	D		Box (B)
#	E		Spikes (S)
#   o       Star
#   !       Music Note
#   *       Goal
#   1       Shoe Snake
#   2       Shoe Snail
# 5 spaces to have a 2 space gap to jump through
BBBBBBBBBBBBBBBBBBBBBBBBBBBBBBBBBBBBBBBBBBBBBBBBBBBBBBBBBBBBBBBBBBBBBBBBBBBBBBBBBBBBBBBBBBBBBBBBBBBBBBBBBBBBBBBBBBBB
BBBCCCCCCCCCCCCCCCCCCCCCCCCCCCCCCCCC                                                                               B
                       2           C                                                                               B
                                                                                                                   B
         CC                        C                                                                               B
         C                         C                                                                               B
         C    B                    BBBBBBBBBBBBBBBBBBBBBBBBBBBBBBBBBBBBBBBBBBBBBBBBBBBBBBBBBBBBBBBBBBBBBBBBBBBBBBBBB
              B                                     B                                                              B
              B                    B                B                                                              B
              B   1     1     1    B                BBB    CC          BBBBBBBBBBBBBBBB                            B
   BBBBBV     BBBBBBBBBBBBBBBBBBBBBB                B      BBB                        BBBBBBBBBBBBBC               B
        C                                                  BBBB                           BBBBBBBBBC               B
        C                                                  BBBBB                                   C               B
                                                         BBBBBBBB                2        1        C   1       o   B
                    BBBBBBB          CB             BBBBBBBBBBBBBBBBBBBBBBBBBBBBBBBBBBBBBBBBBBBBBBBBBBBBBBBBBBBBBBBB
                          C          CB             B                B                B                 B          B
             B            C          CB             B       B        B       C        B         B       B          B
                          C          CB             B       B        B       C        B         B       B          B
     1        1       1       EEEEEE CB  D                  B        B       C        B         B       B          B
EEEEEEEEEEEEBBBBBBBBBBBBBBBBBBBBBBBBBBB                     B                C                  B             o    B
BBBBBBBBBBBB                          BBBBBB        BBBBBBBBBBBBBBBBBBBBBBBBBBBBBBBBBBBBBBBBBBBBBBBBBBBBBBBBBBBBBBBB
               D                                    BBBBBBBBBBBBBBBBBBBBBBBBBBBBBBBBBBBBBBBBBBBBBBBBBBBBBBBBBBBBBBBB	
             EEEEEEEEEEEEEEEEEEEEEEE                BBBBBBBBBBBBBBBBBBBBBBBBBBBBBBBBBBBBBBBBBBBBBBBBBBBBBBBBBBBBBBBB
GGGGGGGGGGGGGGGGGGGGGGGGGGGGGGGGGGGGGGGGGGGGGGGGGGGGGGGGGGGGGGGGGGGGGGGGGGGGGGGGGGGGGGGGGGGGGGGGGGGGGGGGGGGGGGGGGGGG