# MGp file for tile-bGseV gGme
# (Lines thGt stGrt with '#' Gre Eomments)
# The tiles Gre:
#   (Space) Empty tile
#   A		Ground Tile (G)
#	B		Wall-Tile Non-attachable (WN)
#	C		Velcro Tile (V)
#	D		Box (B)
#	E		Spikes (S)
#	F		Velcro Toggle
#	G		Sand 
#   o       Star
#   !       Music Note
#   *       Goal
#   1       Shoe Snake
#   2       Shoe Snail
#   3       ShoeGull
#   4       BrickFlop
+background2.png    
FFFFFFFFFFFFFFFFFFFFFFFFFFFFFFFFFFFFFFFFFFFFFFFFFFFFFFFFFFFFFFFFFFFFFFFFFFFFFFFFFFFFF 
                                                                                    F                                                         
F                                               4                                   F
F          3      3      3    3     3     3                   *                     F
F      CC     CC     CC    CC    CC   CC    CC   CC     FFFFFFFFFFFFFFFFFFFFFF      F
F              4    3    3                                                          F
F                                                                                   F
F                                                                                   F
F  CC             C   C   C                                                         F
F             B   C   C   C                                                         F
FFFFFFFFFFFFFFFFFFFFFFFFFFFFFFFFFFFF       FFFFFFFFFFFFFFFFFFFFFFFFFFFFFFFFF        F
B                                                                          B        F
B                                                                          B   1    F
B                                                                          B    2   F
B                                   CC                                     B        F
B            4         4      CC                                           B  1     F
B        BB             BB                                                 B        F
B  p  C             C                                                      B      1 F
B     CEEEEEEE      CEEEEEEEEEEEEEEEEEEEEEEEEEEEE                          B        F
FFFFFFFFFFFFFFFFFFFFFFFFFFFFFFFFFFFFFFFFFFFFFFFFFFFFFFFFFFFFFFFFFFFFFFFFFFFFFFFFFFFFF