# Map file for tile-based game
# (Lines that start with '#' are comments)
# The tiles are:
#   (Space) Empty tile
#   A		Ground Tile (G)
#	B		Wall-Tile Non-attachable (WN)
#	C		Velcro Tile (V)
#	D		Box (B)
#	E		Spikes (S)
#	F		Velcro Toggle
#	G		Sand 
#   o       Star
#   !       Music Note
#   *       Goal
#   1       Shoe Snake
#   2       Shoe Snail
#   3       ShoeGull
#   4       BrickFlop
+background3.png
BBBBBBBBBBBBBBBBBBBBBBBBBBBBBBBBBBBBBBBBBBBBBBBBBBBBBBBBBBBBBBBBBBBBBBBBBBBBBBBBBBBBBBBBBBBBBBBBBBBBBBBBBBBBBBBBBBBB
BBBCCCCCCCCCCCCCCCCCCCCCCCCCCCCCCCCC                                                                               B
                       2           C                                                                               B
                                                                                                                   B
         CC                        C                                                                               B
         C                         C                                                                               B
         C    B                    BBBBBBBBBBBBBBBBBBBBBBBBBBBBBBBBBBBBBBBBBBBBBBBBBBBBBBBBBBBBBBBBBBBBBBBBBBBBBBBBB
              B                                     B                                                              B
              B                    B                B                                                              B
              B   1     1     1    B                BBB    CC     BBBBBBBBBBBBBBBB                                 B
   BBBBBCBBBB BBBBBBBBBBBBBBBBBBBBBB                B      BBB                        BBBBBBBBBBBBBC               B
        C          B                                B      BBBB                           BBBBBBBBBC               B
        C          B                                B      BBBBB                                   C               B
                   B     o                          B    BBBBBBBB                2        1        C   1       o   B
                   BBBBBBBC          CB             BBBBBBBBBBBBBBBBBBBBBBBBBBBBBBBBBBBBBBBBBBBBBBBBBBBBBBBBBBBBBBBB
                          C          CB             B                B                B                 B          B
             B            C          CB             B                B                B                 B          B
                          C          CB             B                B                B                 B          B
     1        1       1       EEEEEE CB  D                  B        B       C        B         B       B          B
EEEEEEEEEEEEBBBBBBBBBBBBBBBBBBBBBBBBBBB                     B                C                  B                  B
BBBBBBBBBBBB                          B                     B                C                  B                  B
                                      BBBBBB                B                C                  B              o   B
                                                    BBBBBBBBBBBBBBBBBBBBBBBBBBBBBBBBBBBBBBBBBBBBBBBBBBBBBBBBBBBBBBBB
    p          D                                    BBBBBBBBBBBBBBBBBBBBBBBBBBBBBBBBBBBBBBBBBBBBBBBBBBBBBBBBBBBBBBBB	
             EEEEEEEEEEEEEEEEEEE                    BBBBBBBBBBBBBBBBBBBBBBBBBBBBBBBBBBBBBBBBBBBBBBBBBBBBBBBBBBBBBBBB
GGGGGGGGGGGGGGGGGGGGGGGGGGGGGGGGGGGGGGGGGGGGGGGGGGGGGGGGGGGGGGGGGGGGGGGGGGGGGGGGGGGGGGGGGGGGGGGGGGGGGGGGGGGGGGGGGGGG