# Map file for tile-based game
# (Lines that start with '#' are comments)
# The tiles are:
#   (Space) Empty tile
#   A		Ground Tile (G)
#	B		Wall-Tile Non-attachable (WN)
#	C		Velcro Tile (V)
#	D		Box (B)
#	E		Spikes (S)
#	F		Velcro Toggle
#	G		Sand 
#   o       Star
#   !       Music Note
#   *       Goal
#   1       Shoe Snake
#   2       Shoe Snail
#   3       ShoeGull
#   4       BrickFlop
+background3.png
BBBBBBBBBBBBBBBBBBBBBBBBBBBBBBBBBBBBBBBBBBBBBBBBBBBBBBBBBBBBBBBBBBBBBBBBBBBBBBBBBBBBBBBBBBBBBBBBBBBBBBBBBBBBBBBBBBBB
BBBCCCCCCCCCCCCCCCCCCCCCCCCCCCCCCCCC                                                                               B
                       2                                                                                           B
                                                                                                                   B
         CC                                                                                                        B
         C                         C                                                                               B
         C    B                    BBBBBBBBBBBBBBBBBBBBBBBBBBBBBBBBBBBBBBBBBBBBBBBBBBBBBBBBBBBBBBBBBBBBBBBBBBBBBBBBB
              B                                     B                                                              B
              B                    B                B                                                              B
              B   1     1     1    B    CCCCCCCCC   BBB           BBBBBBBBBBBBBBBB                                 B
   BBBBBCBBBB BBBBBBBBBBBBBBBBBBBBBB                       BBB                        CBBBBBBBBBBBBC               B
        C           B                                      BBBB                       C   BBBBBBBBBC               B
        C           B                                      BBBBB                      C            C               B
                    B                                    BBBBBBBB                     C            C           p   B
                    BBBBBBBC          CB             BBBBBBBBBBBBBBBBBBBBBBBBBBBBBBBBBBBBBBBBBBBBBBBBBBBBBBBBBBBBBBBB
                          C          CB             B                B                B                 B          B
             B            C          CB             B                B                B                 B          B
                          C          CB             B                B                B                 B          B
     1        1       1       EEEEEE CB  D                  B        B       C        B         B       B          B
EEEEEEEEEEEEBBBBBBBBBBBBBBBBBBBBBBBBBBB                     B                C                  B                  B
BBBBBBBBBBBB                          B                    BBB               C                 BBB                 B
                                      BBBBBB               BBB               C                 BBB             o   B
                                                    BBBBBBBBBBBBBBBBBBBBBBBBBBBBBBBBBBBBBBBBBBBBBBBBBBBBBBBBBBBBBBBB
               D                                    BBBBBBBBBBBBBBBBBBBBBBBBBBBBBBBBBBBBBBBBBBBBBBBBBBBBBBBBBBBBBBBB	
             EEEEEEEEEEEEEEEEEEE                    BBBBBBBBBBBBBBBBBBBBBBBBBBBBBBBBBBBBBBBBBBBBBBBBBBBBBBBBBBBBBBBB
GGGGGGGGGGGGGGGGGGGGGGGGGGGGGGGGGGGGGGGGGGGGGGGGGGGGGGGGGGGGGGGGGGGGGGGGGGGGGGGGGGGGGGGGGGGGGGGGGGGGGGGGGGGGGGGGGGGG