# Map file for tile-based game
# (Lines that start with '#' are comments)
# The tiles are:
#   (Space) Empty tile
#   A		Ground Tile (G)
#	B		Wall-Tile Non-attachable (WN)
#	C		Velcro Tile (V)
#	D		Box (B)
#	E		Spikes (S)
#	F		Velcro Toggle
#	G		Sand 
#   o       Star
#   !       Music Note
#   *       Goal
#   1       Shoe Snake
#   2       Shoe Snail
#   3       ShoeGull
#   4       BrickFlop
+background3.png
BBBBBBBBBBBBBBBBBBBBBBBBBBBBBBBBBBBBBBBBBBBBBBBBBBBBBBBBBBBBBBBBBBBBBBBBBBBBBBBBBBBBBBBBBBBBBBBBBBBBBBBBBBBBBBBBBBBB
BBBCCCCCCCCCCCCCCCCCCCCCCCCCCCCCCCCC                                                                               B
    C                  2                                                                                           B
    C                                                                                                              B
    C                                                                                                              B
    C                              C                                                                            !  B
    C         B                    BBBBBBBBBBBBBBBBBBBBBBBBBBBBBBBBBBBBBBBBBBBBBBBBBBBBBBBBBBBBBBBBBBBBBBBBBBBBBBBBB
    C         B                                     B                                                              B
              B                    B                B                                                              B
              B   1     1     1    B    CCCCCCCCC   BBB           BBBBBBBBBBBBBBBB                                 B
   BBBBBC     BBBBBBBBBBBBBBBBBBBBBB                       BBB                        CBBBBBBBBBBBBC               B
        C                                                  BBBB                       C   BBBBBBBBBC               B
        C                                                  BBBBB                      C            C               B
        C                                                BBBBBBBB        2        2   C            C               B
        CCC         BBBBBBC          CB             BBBBBBBBBBBBBBBBBBBBBBBBBBBBBBBBBBBBBBBBBBBBBBBBBBBBBBBBBBBBBBBB
                          C          CB             B                B                B                 B          B
             B            C          CB             B                B                B                 B          B
                          C          CB             B                B                B                 B          B
     1        1       1       EEEEEE CB  D                  B        B       C        B         B       B          B
EEEEEEEEEEEEBBBBBBBBBBBBBBBBBBBBBBBBBBB                     B                C                  B                  B
BBBBBBBBBBBB                          B                    BBB               C                 BBB                 B
                                      BBBBBB               BBB               C                 BBB             p   B
                                                    BBBBBBBBBBBBBBBBBBBBBBBBBBBBBBBBBBBBBBBBBBBBBBBBBBBBBBBBBBBBBBBB
               D                                    BBBBBBBBBBBBBBBBBBBBBBBBBBBBBBBBBBBBBBBBBBBBBBBBBBBBBBBBBBBBBBBB	
             EEEEEEEEEEEEEEEEEEE                    BBBBBBBBBBBBBBBBBBBBBBBBBBBBBBBBBBBBBBBBBBBBBBBBBBBBBBBBBBBBBBBB
GGGGGGGGGGGGGGGGGGGGGGGGGGGGGGGGGGGGGGGGGGGGGGGGGGGGGGGGGGGGGGGGGGGGGGGGGGGGGGGGGGGGGGGGGGGGGGGGGGGGGGGGGGGGGGGGGGGG